gfWpjRRQffQGCHHJsGqjsj - gfWpjRRQffQ GCHHJsGqjsj - j 10
SclzJZZvmmnPbJtVSqqNBqVCBdSCsd - SclzJZZvmmnPbJt VSqqNBqVCBdSCsd - S 45
tlbvZJDZtmtPcJmlPnhMFQWWpMRFTfLDRRTWRp - tlbvZJDZtmtPcJmlPnh MFQWWpMRFTfLDRRTWRp - D 30
HjMPgSWjVrjgbHRRSSMRgjRdpdbGdlcdCvQfcCdlwQJfdf - HjMPgSWjVrjgbHRRSSMRgjR dpdbGdlcdCvQfcCdlwQJfdf - b 2
LNDnhtNtLNFFZDtFnhzvdldDflvvDCdlJfldpJ - LNDnhtNtLNFFZDtFnhz vdldDflvvDCdlJfldpJ - D 30
ZFLFZZmFtFtTNTSPRrVPWWMpRP - ZFLFZZmFtFtTN TSPRrVPWWMpRP - T 46
qLBSBLRwmgzqCbzCffDlrfCV - qLBSBLRwmgzq CbzCffDlrfCV - z 26
TFFFHNWFMFFMpHpGHMTHGNhrldWZCsdZsslZlZfrflDVss - TFFFHNWFMFFMpHpGHMTHGNh rldWZCsdZsslZlZfrflDVss - W 49
PTMcPGntTThHhTGctnMvSwjjvmmqLBmnjqqgCR - PTMcPGntTThHhTGctnM vSwjjvmmqLBmnjqqgCR - n 14
nClJtMwwntqVVPJcgZqq - nClJtMwwnt qVVPJcgZqq - J 36
mjpsDcrcSSFFPZqFBWWgVP - mjpsDcrcSSF FPZqFBWWgVP - F 32
vQcjsvhrvvrmhbmNHMNnlHbNMtCtNM - vQcjsvhrvvrmhbm NHMNnlHbNMtCtNM - b 2
bgvvhnTQtjrrrhsDDf - bgvvhnTQt jrrrhsDDf - h 8
pLSMltLzLLSjFrSSjrSJHD - pLSMltLzLLS jFrSSjrSJHD - S 45
zNWRLBdZPllPQtCvttgCqb - zNWRLBdZPll PQtCvttgCqb - P 42
DRlDrrFTNDNlgzsGTBfcnqhhcnJfcrCSqc - DRlDrrFTNDNlgzsGT BfcnqhhcnJfcrCSqc - r 18
MMmmdWtdLmvtldHjMmQfPBqSJWnfCCCqcWSSPJ - MMmmdWtdLmvtldHjMmQ fPBqSJWnfCCCqcWSSPJ - W 49
vjHMjLmjpLtHptQLmHvwTRgNVVpTzZFZgZRlsVTN - vjHMjLmjpLtHptQLmHvw TRgNVVpTzZFZgZRlsVTN - p 16
rzpMpDCGFCFFjRFsRPFRNFPv - rzpMpDCGFCFF jRFsRPFRNFPv - F 32
fWclbHCHtSmfvjnmfsvZ - fWclbHCHtS mfvjnmfsvZ - f 6
wTcTlSwwtQtWclBQBLGMLMCLVzVLwJGqLd - wTcTlSwwtQtWclBQB LGMLMCLVzVLwJGqLd - w 23
MQSjLNjPPLLSBPjfQhSPHjDVCjDtVVpDHwbwVpbD - MQSjLNjPPLLSBPjfQhSP HjDVCjDtVVpDHwbwVpbD - j 10
RcmWzsRrzZrmTszWRqWlmRJscbtHwCbndCtcDVddDpdnVnbt - RcmWzsRrzZrmTszWRqWlmRJs cbtHwCbndCtcDVddDpdnVnbt - c 3
JTsrGGTqmwTlWmTzJzWmhhPLLGgPFgBffSSPhFFM - JTsrGGTqmwTlWmTzJzWm hhPLLGgPFgBffSSPhFFM - G 33
qMMRNZMDDNWLPqfzCgDcGncVDCgG - qMMRNZMDDNWLPq fzCgDcGncVDCgG - D 30
wwBFhwhhBgmcVzhghG - wwBFhwhhB gmcVzhghG - h 8
tbJbjjtJvwtdtwjpFtlbvtdTLNSMqNqMMgqNHPlZRTNggL - tbJbjjtJvwtdtwjpFtlbvtd TLNSMqNqMMgqNHPlZRTNggL - l 12
qmjMHsZmZSbjbZMjSLFFFFwgsgvFswpwww - qmjMHsZmZSbjbZMjS LFFFFwgsgvFswpwww - s 19
hRJBhmnhhvFFwhcv - hRJBhmnh hvFFwhcv - h 8
llfWDWzrzBNTRfNBrWzzTmZbGTMjPqMmZPjVbSZGSP - llfWDWzrzBNTRfNBrWzzT mZbGTMjPqMmZPjVbSZGSP - T 46
CRRPLwwcclcGVppQ - CRRPLwwc clcGVppQ - c 3
SHFjDjjHDTfSDNTTHfSHjQVGrpmllQQWltVVVZGp - SHFjDjjHDTfSDNTTHfSH jQVGrpmllQQWltVVVZGp - j 10
HFlqzDTfqlzwbgPJLwCP - HFlqzDTfql zwbgPJLwCP - z 26
WRCNLphpLppSCWVHNfLRzVnQMnBnMddPMQDFQgrhPQFM - WRCNLphpLppSCWVHNfLRzV nQMnBnMddPMQDFQgrhPQFM - h 8
jTjJqvqjvPVJFJFBJF - jTjJqvqjv PVJFJFBJF - J 36
qTsZbvGqqZlstsmZVljtwqwSHHNWczHSSRcWNSRHzzNfbW - qTsZbvGqqZlstsmZVljtwqw SHHNWczHSSRcWNSRHzzNfbW - b 2
glgzDzHjSrVHcVgbrjmNsscNGmNWssGNNtst - glgzDzHjSrVHcVgbrj mNsscNGmNWssGNNtst - c 3
hHPQLHJpwdLpdHfQQtnZmNMwnZGZWwsFZM - hHPQLHJpwdLpdHfQQ tnZmNMwnZGZWwsFZM - w 23
QpdhPJRTJfPphJfhCBlVqVvgvVDBbvVqDbHD - QpdhPJRTJfPphJfhCB lVqVvgvVDBbvVqDbHD - B 28
VtHzjZpjVtHrprgGmjHsGHNdSJFQRcLJqCdQcSqJNpcq - VtHzjZpjVtHrprgGmjHsGH NdSJFQRcLJqCdQcSqJNpcq - p 16
bBWfTPwhbfDlMnhffRwQJQNdqJcLFQLSdR - bBWfTPwhbfDlMnhff RwQJQNdqJcLFQLSdR - w 23
bhBhvfMWTnlDnTBfPSmvmjsjmmGtzHtsHm - bhBhvfMWTnlDnTBfP SmvmjsjmmGtzHtsHm - v 22
pcRPRPWrSDcJGZSStmwZZS - pcRPRPWrSDc JGZSStmwZZS - S 45
VnLfCfTlfVzfnMMBCqVNZJdtjNtJjhJdGNNbwT - VnLfCfTlfVzfnMMBCqV NZJdtjNtJjhJdGNNbwT - T 46
BLvqCCMVsnRQsPQgDcZH - BLvqCCMVsn RQsPQgDcZH - s 19
cQbqqQhDGhlQfQlhQrqGsTNgLgCpRgLTPPPLNbpg - cQbqqQhDGhlQfQlhQrqG sTNgLgCpRgLTPPPLNbpg - b 2
wtHVddVFwSHznZwwznCpRBdjppNBNTTdCjRR - wtHVddVFwSHznZwwzn CpRBdjppNBNTTdCjRR - d 4
ZtWFwWtSmvVnwZDrCMGfQlDDJQmD - ZtWFwWtSmvVnwZ DrCMGfQlDDJQmD - m 13
PzPZGCZzrZrlhdjdCqfCsqQdRD - PzPZGCZzrZrlh djdCqfCsqQdRD - C 29
cbvZLVVFvbbNSNFHSDnsDQdnfqNQDRngsR - cbvZLVVFvbbNSNFHS DnsDQdnfqNQDRngsR - N 40
FJHSLSFSScJJbWHFmFVFSZmrrzBmhtBwmzBMPMPzPh - FJHSLSFSScJJbWHFmFVFS ZmrrzBmhtBwmzBMPMPzPh - m 13
nlpFcLBgcVcLbssGVBGGrlpGPhJJJJJqPBZPDNMQMJJhJQZZ - nlpFcLBgcVcLbssGVBGGrlpG PhJJJJJqPBZPDNMQMJJhJQZZ - B 28
SSTjHzfHwtZSPVQVQMRQ - SSTjHzfHwt ZSPVQVQMRQ - S 45
TzVHwWfTtzwdVzsbFnGgsbdcGrLc - TzVHwWfTtzwdVz sbFnGgsbdcGrLc - d 4
FppVBRVZDdLmrDGmmfrQ - FppVBRVZDd LmrDGmmfrQ - D 30
NtNMPNshJCzznLGJSrqRrRrr - NtNMPNshJCzz nLGJSrqRrRrr - J 36
tRssthhPlCWhPzsWtzhzCbVVjwTpVwdZZTpwjbdBbwBc - tRssthhPlCWhPzsWtzhzCb VVjwTpVwdZZTpwjbdBbwBc - b 2
TTWblHWScvPCCHTWFzSrqqsNNSmdmqrrpz - TTWblHWScvPCCHTWF zSrqqsNNSmdmqrrpz - S 45
RLRwjjnjZNprzmmZcq - RLRwjjnjZ NprzmmZcq - Z 52
QQgtQnccQDGjgLDRRcLthQhFBvCbMtMHTWlBFllBbFCMTW - QQgtQnccQDGjgLDRRcLthQh FBvCbMtMHTWlBFllBbFCMTW - t 20
WnBVNvDnVsNvZWdrWDLVDMbsHpTjpHCSSClsbSCCMH - WnBVNvDnVsNvZWdrWDLVD MbsHpTjpHCSSClsbSCCMH - s 19
GPFtmztzgPhRFtJTdbTwjppSCjpgSl - GPFtmztzgPhRFtJ TdbTwjppSCjpgSl - g 7
hJcfPtQhdtWNVZqNnqNQ - hJcfPtQhdt WNVZqNnqNQ - Q 43
GLcqZPPsnqQcFsmBBrqRvrddNqrC - GLcqZPPsnqQcFs mBBrqRvrddNqrC - q 17
MtHthJwLllwvjRvvtrvBRS - MtHthJwLllw vjRvvtrvBRS - t 20
VHMfDLbpfznszZQG - VHMfDLbp fznszZQG - f 6
WBSdPlQPRfBtGQPfBGPBJgzgjwsJzsszJwCrdwCT - WBSdPlQPRfBtGQPfBGPB JgzgjwsJzsszJwCrdwCT - d 4
ZpppVpMVpnVHMVVbZRJrCgwRzTJrwNJw - ZpppVpMVpnVHMVVb ZRJrCgwRzTJrwNJw - Z 52
MvhmnpLqLmhVmBlftRQBFSlR - MvhmnpLqLmhV mBlftRQBFSlR - m 13
hhQlSJqhtCSnqZJnqShSlNDwRzpvdwRlMBMMdcjRjMpMRc - hhQlSJqhtCSnqZJnqShSlND wRzpvdwRlMBMMdcjRjMpMRc - l 12
frrGmLmWbfFrsmFHmBzBvBcwdJbvpjzbMM - frrGmLmWbfFrsmFHm BzBvBcwdJbvpjzbMM - b 2
mmgFrVGLWJLFGsgfhSVtVPqntqnnSStN - mmgFrVGLWJLFGsgf hSVtVPqntqnnSStN - V 48
SFJTJTSqswwFQbwf - SFJTJTSq swwFQbwf - F 32
cDtcWPclrtPwVsfssQmN - cDtcWPclrt PwVsfssQmN - P 42
HDtwWCgWdggdzSGJMSzGMq - HDtwWCgWdgg dzSGJMSzGMq - d 4
JpqJtWRJMhCMJpMQCWtFrjgHdgdlgllwNjlQjldH - JpqJtWRJMhCMJpMQCWtF rjgHdgdlgllwNjlQjldH - Q 43
fBzPZcZvnBmDnZvZBZDmPvglVVVdgHHSwrNRgVgwNPRH - fBzPZcZvnBmDnZvZBZDmPv glVVVdgHHSwrNRgVgwNPRH - P 42
GbZnZccfvcsZmccsmnnZTRbCCMWFTWJqFCCMJFRT - GbZnZccfvcsZmccsmnnZ TRbCCMWFTWJqFCCMJFRT - b 2
vrrFqrFTBTmLmNrLMqMTHddJbHpWnhdWdWbHhJGM - vrrFqrFTBTmLmNrLMqMT HddJbHpWnhdWdWbHhJGM - M 39
wBzfwzcQSzWSSshpdWGp - wBzfwzcQSz WSSshpdWGp - S 45
gwjPPPDQtzQlzQDPqTgLBRmRqZBvqFNR - gwjPPPDQtzQlzQDP qTgLBRmRqZBvqFNR - g 7
bWVptFFsbPcZsGLhsZGmLB - bWVptFFsbPc ZsGLhsZGmLB - s 19
qnWrnrHdMCDCNqfWmvRRZSSRLdRGZGRG - qnWrnrHdMCDCNqfW mvRRZSSRLdRGZGRG - d 4
nNqqNDfMrMWHDQNHzWfHNDnwzblpzFlbwtFbVVlwVcPJpP - nNqqNDfMrMWHDQNHzWfHNDn wzblpzFlbwtFbVVlwVcPJpP - z 26
BHJhlHdJQggvddglJBBhglhQzZHPZpFFPDMzFDDRDFZZDFZD - BHJhlHdJQggvddglJBBhglhQ zZHPZpFFPDMzFDDRDFZZDFZD - H 34
rSTfqnCffMfCVfCLNqbzbjWNDbbWDPFpPFbP - rSTfqnCffMfCVfCLNq bzbjWNDbbWDPFpPFbP - N 40
nfnnrSfCTVSwrqSLCGfTGlgQhlvsGMJQJBhhssJhGc - nfnnrSfCTVSwrqSLCGfTG lgQhlvsGMJQJBhhssJhGc - G 33
tBjjDjjqfDjLfJlrLgglvmrlmrcc - tBjjDjjqfDjLfJ lrLgglvmrlmrcc - L 38
TwNNTVhwwpgvGSNNSssS - TwNNTVhwwp gvGSNNSssS - N 40
TbwhnvvChhbVRTPPRJBJQQfJttMQQJCQfW - TbwhnvvChhbVRTPPR JBJQQfJttMQQJCQfW - C 29
mWSvSQVgmWQsQvspQJlrlLnJLLpCClhhlp - mWSvSQVgmWQsQvspQ JlrlLnJLLpCClhhlp - p 16
bFHRjZdNjjBZzFzhtnCllCcJLrCBll - bFHRjZdNjjBZzFz htnCllCcJLrCBll - B 28
HFFNHbdZZLZjfPFjHVQmWDDVsvsmTqVqDf - HFFNHbdZZLZjfPFjH VQmWDDVsvsmTqVqDf - f 6
JJPllQQClqgBCgdHwHbpjVTwHd - JJPllQQClqgBC gdHwHbpjVTwHd - g 7
tmGZtjGjHZpVbfMT - tmGZtjGj HZpVbfMT - Z 52
ShGjNGWmDSNcNRtGmshDRzzCvzQJJRBLrvlrBPJv - ShGjNGWmDSNcNRtGmshD RzzCvzQJJRBLrvlrBPJv - R 44
cTpqsTWqVVpsNLfvCDFlMFDVFL - cTpqsTWqVVpsN LfvCDFlMFDVFL - V 48
JnndJPddQgzHlvMJFDhLCG - JnndJPddQgz HlvMJFDhLCG - J 36
BjtntgdRnQgzjdBRQBlpNWrTTlNTSwNpWS - BjtntgdRnQgzjdBRQ BlpNWrTTlNTSwNpWS - B 28
qHmqLVLjmVqsDBLtmjmbtPwCTwwPzGWRgGwGwMwW - qHmqLVLjmVqsDBLtmjmb tPwCTwwPzGWRgGwGwMwW - t 20
ZhcCNCSprRTWTwSnWW - ZhcCNCSpr RTWTwSnWW - S 45
hflhZvvQhppZfcNpvrhpQHjVjLmbVmmVHVCFDvqVFb - hflhZvvQhppZfcNpvrhpQ HjVjLmbVmmVHVCFDvqVFb - v 22
nnNrwDnZrspwDNnZsNSDsNbCmpjvMTPQjLMmPmmQPGBTQP - nnNrwDnZrspwDNnZsNSDsNb CmpjvMTPQjLMmPmmQPGBTQP - p 16
FdVtRdRfctBQPmTtTLQB - FdVtRdRfct BQPmTtTLQB - t 20
qhzWVWJqVHwbhlLSsS - qhzWVWJqV HwbhlLSsS - h 8
htWmhDhFztnztDhtBmBtghPRSrpfjVwPdfPwpwnRSVrr - htWmhDhFztnztDhtBmBtgh PRSrpfjVwPdfPwpwnRSVrr - n 14
cbCHvgJGcTqbqcbqqqcqsMsRVrSCwffdRPPpVpwCRSwfjj - cbCHvgJGcTqbqcbqqqcqsMs RVrSCwffdRPPpVpwCRSwfjj - C 29
GlgGQqTqbgQzttmBNNFz - GlgGQqTqbg QzttmBNNFz - Q 43
NWQNQgdTgjQNddTZfrCQWRDnnnbqnLqnRcjJlqqvDj - NWQNQgdTgjQNddTZfrCQW RDnnnbqnLqnRcjJlqqvDj - j 10
FtSSmSmJhpllcclDvpln - FtSSmSmJhp llcclDvpln - p 16
JBVVSsSFBVBttShFGSPQfCGNdrMfZZTQTZNNdC - JBVVSsSFBVBttShFGSP QfCGNdrMfZZTQTZNNdC - G 33
HgHthMhphcbfbMMfHhsGGDCRRVlcVSScsCRz - HgHthMhphcbfbMMfHh sGGDCRRVlcVSScsCRz - c 3
nWvPFqLqPNdjnNLnjdJnPdWjGlssDPSsllVCRzlTCTGlSDzS - nWvPFqLqPNdjnNLnjdJnPdWj GlssDPSsllVCRzlTCTGlSDzS - P 42
RvddJRJQHwQwpZZb - RvddJRJQ HwQwpZZb - Q 43
gdZwgpjZZQtHTdrWrwdpWRnlhNBRlLbFthNhflhBnL - gdZwgpjZZQtHTdrWrwdpW RnlhNBRlLbFthNhflhBnL - t 20
CVzDCPGMVqVmGsGGbJCmCDvMcRcqnBFFFnRBBNRBBNqhnFfF - CVzDCPGMVqVmGsGGbJCmCDvM cRcqnBFFFnRBBNRBBNqhnFfF - q 17
DsmSGsGPzvMGJvdbgTSTbjbSSdgH - DsmSGsGPzvMGJv dbgTSTbjbSSdgH - S 45
jBGmbNBQGdBNNDJNQRLLVDsHtDRzHHZZcH - jBGmbNBQGdBNNDJNQ RLLVDsHtDRzHHZZcH - D 30
wCWPFWPCrPhPrplvprhwpCHHtszttqZslRVHLtzVlJZL - wCWPFWPCrPhPrplvprhwpC HHtszttqZslRVHLtzVlJZL - l 12
vprMMvMnJCwnnPShNGSTfGSfNmmgdNff - vprMMvMnJCwnnPSh NGSTfGSfNmmgdNff - S 45
bPtLbvVWWztbLSVVnbszpzQsrcDDBdpRcDrs - bPtLbvVWWztbLSVVnb szpzQsrcDDBdpRcDrs - z 26
llZmgCZqgCFgmdRdJcscBdJsmQ - llZmgCZqgCFgm dRdJcscBdJsmQ - m 13
FZlgfqCFfgZHlqCMCglwCFGWntLLSMRSPGPVttWRtVGL - FZlgfqCFfgZHlqCMCglwCF GWntLLSMRSPGPVttWRtVGL - M 39
vtnDsDtrnrSvrMVmbrrJgPCmBm - vtnDsDtrnrSvr MVmbrrJgPCmBm - r 18
FpQHzFclLVzWHhwHLQLlHLzPmMBQCJTdTmCTmBTJTTmgQg - FpQHzFclLVzWHhwHLQLlHLz PmMBQCJTdTmCTmBTJTTmgQg - Q 43
pllcVWqlffZqZtZD - pllcVWql ffZqZtZD - q 17
TSSZWpsQmZWcTZSvsTTTppNPzrBPrNBrzQNVFrBBNPqP - TSSZWpsQmZWcTZSvsTTTpp NPzrBPrNBrzQNVFrBBNPqP - Q 43
CgjmCbtGgftMmLtLmffzBzJJJNVVMNzNBqJrFN - CgjmCbtGgftMmLtLmff zBzJJJNVVMNzNBqJrFN - M 39
gjgjLgtLwgbGjHdhhGdvmlnllnpWnplZvcvwTl - gjgjLgtLwgbGjHdhhGd vmlnllnpWnplZvcvwTl - w 23
htLrRFRtbbhlGSLRtbJBJsjBmgMMgJgtmBzz - htLrRFRtbbhlGSLRtb JBJsjBmgMMgJgtmBzz - t 20
pZQWddQQfpZZffcDQZwddQwDMqDDsPgGJJzzjqzgJMBJgmms - pZQWddQQfpZZffcDQZwddQwD MqDDsPgGJJzzjqzgJMBJgmms - D 30
QdcQTdwpGNwfrCRlRVlNLSbb - QdcQTdwpGNwf rCRlRVlNLSbb - N 40
wrdvpVBVpMGPPjWjGZJJZT - wrdvpVBVpMG PPjWjGZJJZT - G 33
tChCSlNfCCHtvHHWPHPZ - tChCSlNfCC HtvHHWPHPZ - t 20
RbRRNvmcqcblfMwwdVBQQqqdpL - RbRRNvmcqcblf MwwdVBQQqqdpL - q 17
qcctqRcqmcHWzHBdDMZhfwthBnwt - qcctqRcqmcHWzH BdDMZhfwthBnwt - t 20
JFsSNMSgNSNJJMGJBBdjhFDfhwhBrwnZ - JFsSNMSgNSNJJMGJ BBdjhFDfhwhBrwnZ - F 32
TbgbsSgJMTJllblLCSPlsTCVQmRVVWpQzzqpqzVzHLQzcc - TbgbsSgJMTJllblLCSPlsTC VQmRVVWpQzzqpqzVzHLQzcc - L 38
CVcWbjjSSCSSnpjWpCpprhHZlHtHGzHrZrHGclrl - CVcWbjjSSCSSnpjWpCpp rhHZlHtHGzHrZrHGclrl - c 3
gqZqdddLgmgNqvTGGHvvmrrGHT - gqZqdddLgmgNq vTGGHvvmrrGHT - m 13
FFDgZfZNLMgNfdDqDRnsnjBpbSbnMBBWpQpB - FFDgZfZNLMgNfdDqDR nsnjBpbSbnMBBWpQpB - M 39
qwpQFwRnqFFfSBSfFt - qwpQFwRnq FFfSBSfFt - F 32
LJJLGLWWtZlbgWHgGshhSdSVzmhHmfVzzC - LJJLGLWWtZlbgWHgG shhSdSVzmhHmfVzzC - H 34
lrbrbrNNJgDMLLbblGctvvvDqPcqctTTTcqP - lrbrbrNNJgDMLLbblG ctvvvDqPcqctTTTcqP - D 30
vnblvbfHvlcHMlHlZbSPLTPLwCMBRRPRRFFR - vnblvbfHvlcHMlHlZb SPLTPLwCMBRRPRRFFR - M 39
tszzBqtzDsWVPRSmzLVmVL - tszzBqtzDsW VPRSmzLVmVL - z 26
tsNsDDNgGsqBrgBpgdHQbfhflcHdpZvdbh - tsNsDDNgGsqBrgBpg dHQbfhflcHdpZvdbh - p 16
cCpLtpGGLsgsppcpmGGHMtjfHRVhvvVVFRfhjV - cCpLtpGGLsgsppcpmGG HMtjfHRVhvvVVFRfhjV - t 20
NWnnnNNndQnQZdCdzzRVMHzvhhHWWWjj - NWnnnNNndQnQZdCd zzRVMHzvhhHWWWjj - W 49
CPJJrnSZpGDJLGTL - CPJJrnSZ pGDJLGTL - J 36
cnJzpcnmnQVFbzTlvTHBlb - cnJzpcnmnQV FbzTlvTHBlb - z 26
tWCDPjfsDGfZhddhjjdTvFTgFgvbnFHvdHqT - tWCDPjfsDGfZhddhjj dTvFTgFgvbnFHvdHqT - d 4
hjfCjwDDGjPthsfhsnGNrJcQcRmJMLVJrJNMLw - hjfCjwDDGjPthsfhsnG NrJcQcRmJMLVJrJNMLw - w 23
CPPRrSlRccPcwTHwfdwTHdfl - CPPRrSlRccPc wTHwfdwTHdfl - l 12
mLQLLjhQhhQLZvpzssHDhdTswzzTJD - mLQLLjhQhhQLZvp zssHDhdTswzzTJD - h 8
gmjbBvQLWmgbQZBCSRnnnSMVCBHnBS - gmjbBvQLWmgbQZB CSRnnnSMVCBHnBS - B 28
sWrBJbsVqschzhQzHh - sWrBJbsVq schzhQzHh - s 19
gtFmztnSlSfdlmnZSdSwcwGRTjcTcwwTcHccRg - gtFmztnSlSfdlmnZSdS wcwGRTjcTcwwTcHccRg - g 7
FzFDzMZCdDZtCSrJVBMqWVrqNBqN - FzFDzMZCdDZtCS rJVBMqWVrqNBqN - M 39
TvWlhhfhZJVgtSSl - TvWlhhfh ZJVgtSSl - l 12
ddBdGGdFmmBbdzqqPDDGGmdDZSgttHtZppSgzZHSgMhtMgtz - ddBdGGdFmmBbdzqqPDDGGmdD ZSgttHtZppSgzZHSgMhtMgtz - z 26
PGqdrbbbdPnrcjjhTRWLLc - PGqdrbbbdPn rcjjhTRWLLc - r 18
trrmJWcrVwVbcPScdcBdGPHH - trrmJWcrVwVb cPScdcBdGPHH - c 3
JTQnfjlJTpQFfMLlNJHHGDPdGsSdDjHGDPPH - JTQnfjlJTpQFfMLlNJ HHGDPdGsSdDjHGDPPH - j 10
ffFfnCTTCfTlplTMvNVzqWvwVzrrhwmWhJbW - ffFfnCTTCfTlplTMvN VzqWvwVzrrhwmWhJbW - v 22
hVtDtgcghzJpmmhlwp - hVtDtgcgh zJpmmhlwp - h 8
srsnrqqsPqsBPvnqRBRMPbnwlplpmCStJwmzJPtJzJfwSw - srsnrqqsPqsBPvnqRBRMPbn wlplpmCStJwmzJPtJzJfwSw - P 42
bbrqjBbvGsjGGBWqMVFFVDNVNjZjgtgFgZ - bbrqjBbvGsjGGBWqM VFFVDNVNjZjgtgFgZ - j 10
mnmhBDHhwWCHsTgRsH - mnmhBDHhw WCHsTgRsH - H 34
dcSlFvccMFMMFFggNsTzzvvzWnVW - dcSlFvccMFMMFF ggNsTzzvvzWnVW - v 22
llQdllZScFplJPpdcZSqBqjhmtnrwrDGnQGhrq - llQdllZScFplJPpdcZS qBqjhmtnrwrDGnQGhrq - Q 43
ZffVNgfTdmPVltsnnGwgQDnB - ZffVNgfTdmPV ltsnnGwgQDnB - g 7
rMCFLMHpzCMFzHpzbrcHFLzBwsDsDDnlDBJrDDBBSJSnBn - rMCFLMHpzCMFzHpzbrcHFLz BwsDsDDnlDBJrDDBBSJSnBn - r 18
MLMjMzqpCzvwqTmwZdvq - MLMjMzqpCz vwqTmwZdvq - q 17
DDNlWPRqgPRPsRFjJQZbchJZbgQJ - DDNlWPRqgPRPsR FjJQZbchJZbgQJ - g 7
zzrLLznpLbHnjcBHvVvHvJcZ - zzrLLznpLbHn jcBHvVvHvJcZ - H 34
ndmrTzbMMTfzrTfnTLrzdpmsPPPqlqGDNNsPCRDRqRsD - ndmrTzbMMTfzrTfnTLrzdp msPPPqlqGDNNsPCRDRqRsD - m 13
zzdqTNfTfdfhgQhgqMFSjRDtDRWHqtWlwtqDRS - zzdqTNfTfdfhgQhgqMF SjRDtDRWHqtWlwtqDRS - q 17
ssBCrcmpVGZvVRDdSDRwtmWdDb - ssBCrcmpVGZvV RDdSDRwtmWdDb - m 13
rvGPCZLCVCPVBZFdnfThgNgLJNhf - rvGPCZLCVCPVBZ FdnfThgNgLJNhf - L 38
bslcrssQwDPbQrrcsbsnQrjMLthPMMRhLRhLRgzmgPhRgM - bslcrssQwDPbQrrcsbsnQrj MLthPMMRhLRhLRgzmgPhRgM - P 42
DffvDfHGfNFdpfTdMtghLBThzVmBhBtM - DffvDfHGfNFdpfTd MtghLBThzVmBhBtM - T 46
SNvJNJdflDDbcDWJ - SNvJNJdf lDDbcDWJ - J 36
HFlHNpWsTlGWbFsGFTGHFLLNzPPhLVPMzVzMNPhhzP - HFlHNpWsTlGWbFsGFTGHF LLNzPPhLVPMzVzMNPhhzP - N 40
jSvZtmrqqpcrCpPVzw - jSvZtmrqq pcrCpPVzw - r 18
dddQvqDgDmjdSQQdqZjStpffWGgBRWTGfGsRlWBlHF - dddQvqDgDmjdSQQdqZjSt pffWGgBRWTGfGsRlWBlHF - g 7
THnTbNrdBnLTHHnTnBrWRTndsccZsLZcDqmLDPcDlQDsmmsZ - THnTbNrdBnLTHHnTnBrWRTnd sccZsLZcDqmLDPcDlQDsmmsZ - L 38
ptwzzhpvGSVdqQlmszqmqPqc - ptwzzhpvGSVd qQlmszqmqPqc - z 26
wGVjSddCBggCHFWN - wGVjSddC BggCHFWN - C 29
LFFbdbhhhvwvfTNdRhhRRvMbHDGjcfcGfDjtDHHcHqGjDqqj - LFFbdbhhhvwvfTNdRhhRRvMb HDGjcfcGfDjtDHHcHqGjDqqj - f 6
WlQnVpWSSWWsPsgDqDzHDLHjJcttGP - WlQnVpWSSWWsPsg DqDzHDLHjJcttGP - P 42
rrWsZrgVnWrWSlmSlmSBFFbvTThhBFvvZLBhRw - rrWsZrgVnWrWSlmSlmS BFFbvTThhBFvvZLBhRw - Z 52
BgBdcjThvjFcTggrqvVfzlnnPlrqLt - BgBdcjThvjFcTgg rqvVfzlnnPlrqLt - v 22
JpwJGPsQwpwSssHpPLlzlnNlzLLNNLVtsN - JpwJGPsQwpwSssHpP LlzlnNlzLLNNLVtsN - s 19
JPMmWGmWPmHbHpJbWGJmDmwbBTRZMBBdZCRTRjFjhCZCCBTT - JPMmWGmWPmHbHpJbWGJmDmwb BTRZMBBdZCRTRjFjhCZCCBTT - M 39
BjbcLFRfBRhnbGjCVVvPllpcPtcDmdlPpvPP - BjbcLFRfBRhnbGjCVV vPllpcPtcDmdlPpvPP - c 3
WrMQqCNgsqWWsTNCMZMWWsWPvJDJDddvlpDtZDpDDDDwvP - WrMQqCNgsqWWsTNCMZMWWsW PvJDJDddvlpDtZDpDDDDwvP - Z 52
qNMzzSzSQsGLbFCSCnVR - qNMzzSzSQs GLbFCSCnVR - S 45
tTRpHJQpQBZcddhhMhvhJN - tTRpHJQpQBZ cddhhMhvhJN - J 36
zswljflgMFbwPqmNmSdvShLNfLhm - zswljflgMFbwPq mNmSdvShLNfLhm - f 6
qFbsMCVgsqMwRWHCWDDBDWpt - qFbsMCVgsqMw RWHCWDDBDWpt - C 29
VSTCCWsJvGpHHCNC - VSTCCWsJ vGpHHCNC - C 29
GrqzZrrZjDljcDDlfjMqgRPfPvQPpBHNvHvBpvNQ - GrqzZrrZjDljcDDlfjMq gRPfPvQPpBHNvHvBpvNQ - f 6
rljncDcznjMqhlhZDnltrzhTsGWtbVLFTTWGsbdWJdFTmL - rljncDcznjMqhlhZDnltrzh TsGWtbVLFTTWGsbdWJdFTmL - t 20
mJPDSJJPZPJNrprSNrDmpZGrhFFhBqjGbGGVbFjhhfqBjBRV - mJPDSJJPZPJNrprSNrDmpZGr hFFhBqjGbGGVbFjhhfqBjBRV - G 33
cgnTQHdMQdTHdhqfggBhVqVfVS - cgnTQHdMQdTHd hqfggBhVqVfVS - g 7
nQdLLddssSJrmsNvZrPz - nQdLLddssS JrmsNvZrPz - s 19
jfjffQzZQQMzZZfZZQFgjDWBCRlCBdTTBGGGRpBCgdhdBG - jfjffQzZQQMzZZfZZQFgjDW BCRlCBdTTBGGGRpBCgdhdBG - g 7
LrstWtNsbHLsprRBdlGpCwlh - LrstWtNsbHLs prRBdlGpCwlh - r 18
HLnntbnscqLvvPNNfMWSSmDMDPjzjDzS - HLnntbnscqLvvPNN fMWSSmDMDPjzjDzS - P 42
vhcGwWVvglltcfBn - vhcGwWVv glltcfBn - c 3
BBSLrzSJLzJNJrLfPfPRsmDRmflD - BBSLrzSJLzJNJr LfPfPRsmDRmflD - L 38
jMjFZJNMqzrzZzFNFjNQqJzbCpBBvWdpvTCWhpVwdvHVCGbG - jMjFZJNMqzrzZzFNFjNQqJzb CpBBvWdpvTCWhpVwdvHVCGbG - b 2
HlrnFmRmtRBQPVBTQHHQ - HlrnFmRmtR BQPVBTQHHQ - H 34
psSLJsLpTTdPdLTv - psSLJsLp TTdPdLTv - L 38
fCGgTgfSSCtRtFFzql - fCGgTgfSS CtRtFFzql - C 29
pfTpStppcDlWfbpDdzQRsQGJhfffQgJHzN - pfTpStppcDlWfbpDd zQRsQGJhfffQgJHzN - f 6
ZFZFZmBFwVwBVmLmLsRLRhHNzRLRNNzJ - ZFZFZmBFwVwBVmLm LsRLRhHNzRLRNNzJ - L 38
FnnjwVPmnqqqjBjrTdblldCTpcPJtbTD - FnnjwVPmnqqqjBjr TdblldCTpcPJtbTD - P 42
bdZHdWlrjslMMwGG - bdZHdWlr jslMMwGG - l 12
rDDTRBTqSqmJLBJRBTSJpmMsMMjhwvfMhjjfVGsLshhC - rDDTRBTqSqmJLBJRBTSJpm MsMMjhwvfMhjjfVGsLshhC - L 38
BqQFRPFRQBJgzrcZNHFdZt - BqQFRPFRQBJ gzrcZNHFdZt - F 32
wrDdLlDdPWZPTTrwlZpSsPsHVHsSCHnbzMHM - wrDdLlDdPWZPTTrwlZ pSsPsHVHsSCHnbzMHM - P 42
JtNFttNCjFvpppnMpJgSVS - JtNFttNCjFv pppnMpJgSVS - J 36
NFFqFcCQCvfrZmGdZdmqrW - NFFqFcCQCvf rZmGdZdmqrW - q 17
GMNNfJnNddJFJWsv - GMNNfJnN ddJFJWsv - J 36
HSDwCmmghLmwmmHDpsvdFpMWpppptSbp - HSDwCmmghLmwmmHD psvdFpMWpppptSbp - S 45
zCzBCgzhwmhzLrPnVrMqZBNfGf - zCzBCgzhwmhzL rPnVrMqZBNfGf - B 28
DrHGtbltbCjjjffPrgsmzmcqsgDczdsmgJ - DrHGtbltbCjjjffPr gsmzmcqsgDczdsmgJ - D 30
VZLwQLZLLVwLBQZnLVphhLQQqsTNmzJdcNTzzmJNqlNBsszz - VZLwQLZLLVwLBQZnLVphhLQQ qsTNmzJdcNTzzmJNqlNBsszz - B 28
wZLhVMplpQVRRlpVGPfjCjMGCrbHGWWb - wZLhVMplpQVRRlpV GPfjCjMGCrbHGWWb - M 39
BHpFrHHbBNTWWTWNhCPwPLNPjCdjLV - BHpFrHHbBNTWWTW NhCPwPLNPjCdjLV - N 40
zJRRzJvZlcZsSMJdzSDjDtfDCtDtjDjjjj - zJRRzJvZlcZsSMJdz SDjDtfDCtDtjDjjjj - S 45
dcJcszQJJGRJzRllMpGHpFTWmrTmBTbWWB - dcJcszQJJGRJzRllM pGHpFTWmrTmBTbWWB - G 33
qnWWqhDhnjmjCMBlNRrfVfRNCB - qnWWqhDhnjmjC MBlNRrfVfRNCB - C 29
vvBLBtGHJTHBddrNVJrVSVdr - vvBLBtGHJTHB ddrNVJrVSVdr - J 36
BZLTHbgvHvTFBgTFFvhmWmmZDPmmZDsnqncs - BZLTHbgvHvTFBgTFFv hmWmmZDPmmZDsnqncs - Z 52
WBvmjDbSzTMmHHdpNHNF - WBvmjDbSzT MmHHdpNHNF - m 13
ttlflZRfGtfWVRltGtflCdHnJrNJHNHnJddNMNCnpF - ttlflZRfGtfWVRltGtflC dHnJrNJHNHnJddNMNCnpF - C 29
VVwssWQQfRGZcszBQzDbjSBvSBDP - VVwssWQQfRGZcs zBQzDbjSBvSBDP - Q 43
lSlQqQVqWWVWfqQWVJSTscdmPPwwTTmjjfpjPp - lSlQqQVqWWVWfqQWVJS TscdmPPwwTTmjjfpjPp - f 6
FCbzHbvHvtgrtFCvbvbbwdTwmsrwnTTpmdswmwcc - FCbzHbvHvtgrtFCvbvbb wdTwmsrwnTTpmdswmwcc - r 18
DtZbHdghztlLMQlWWhVQ - DtZbHdghzt lLMQlWWhVQ - h 8
pqzzFSmdFqbQvlpdDGGrGBWPPBVNQnVttZ - pqzzFSmdFqbQvlpdD GGrGBWPPBVNQnVttZ - Q 43
cgcjwfBMhHCjjLMCrtcnPcsnsPGVnrVs - cgcjwfBMhHCjjLMC rtcnPcsnsPGVnrVs - c 3
JgCChjjjBHhRRLLjjhplzvzpSFJvzzlDbSqm - JgCChjjjBHhRRLLjjh plzvzpSFJvzzlDbSqm - J 36
mZzVQZMhmrffwfQhWhzmrmpBtRcdbnbcdcMpBbDbncdD - mZzVQZMhmrffwfQhWhzmrm pBtRcdbnbcdcMpBbDbncdD - M 39
jsLTSlTWRBSDpnDn - jsLTSlTW RBSDpnDn - S 45
GLTsGWGFsfmJGZVJZm - GLTsGWGFs fmJGZVJZm - G 33
BGWshBGnsFWSLWBLlSSLWRJHnrVPrPcNHCNHctnPPJ - BGWshBGnsFWSLWBLlSSLW RJHnrVPrPcNHCNHctnPPJ - n 14
QmvQCqqMTZqvgmvTjpZCMgMtrVctPptHtrNVrptbJJbrRP - QmvQCqqMTZqvgmvTjpZCMgM trVctPptHtrNVrptbJJbrRP - p 16
CzjCZfCwDzShDWdF - CzjCZfCw DzShDWdF - z 26
HmQlQHmJnpmptmzt - HmQlQHmJ npmptmzt - m 13
MTqMjMPvTvVvhpdztZnSwzwZqS - MTqMjMPvTvVvh pdztZnSwzwZqS - q 17
CcbLLPTMtCCsjHNHQFLRRFlRNN - CcbLLPTMtCCsj HNHQFLRRFlRNN - L 38
GDFwLLLLSrbdPlFBMFsslFHmZH - GDFwLLLLSrbdP lFBMFsslFHmZH - F 32
TnJCgthHpVTfZMQZQmzWnZ - TnJCgthHpVT fZMQZQmzWnZ - n 14
hjvtjtghtqJvVjhTgNhJTvdvdDDRbbccrwPdcGwrHS - hjvtjtghtqJvVjhTgNhJT vdvdDDRbbccrwPdcGwrHS - v 22
MQQMBPzMGQBPBbDQPMhpnRwsGnRhNrFFpRnF - MQQMBPzMGQBPBbDQPM hpnRwsGnRhNrFFpRnF - G 33
vmgHcmCTTlvvvZvTmqcTfmCRdddFnwdRdnVwFpVfpRnwNw - vmgHcmCTTlvvvZvTmqcTfmC RdddFnwdRdnVwFpVfpRnwNw - f 6
gvmqJTcHclCQJNzjMLWbLj - gvmqJTcHclC QJNzjMLWbLj - J 36
DbqqDDbQFqfNtZSLSq - DbqqDDbQF qfNtZSLSq - q 17
RrdjPdmrpWBdmWRdccfLtNttSDMZBfftLMLf - RrdjPdmrpWBdmWRdcc fLtNttSDMZBfftLMLf - B 28
dCcgmgRrWcgcppjCVVVVFHFnDnbJnb - dCcgmgRrWcgcppj CVVVVFHFnDnbJnb - C 29
fZMFfrtVdZSDVwTgjRMLhwTCLj - fZMFfrtVdZSDV wTgjRMLhwTCLj - M 39
cNzPBNpclllzHbmTNRhqCRTgjC - cNzPBNpclllzH bmTNRhqCRTgjC - N 40
nhhWJzhGPlQcGvsvfJtSfZfrtt - nhhWJzhGPlQcG vsvfJtSfZfrtt - J 36
PSzrBWQBBGzBlnSnWtDrqHfNfwVwHcLNjHjwcDNmFH - PSzrBWQBBGzBlnSnWtDrq HfNfwVwHcLNjHjwcDNmFH - D 30
hbRhtRCRpRvsRgVVVcNHNNNCwLwc - hbRhtRCRpRvsRg VVVcNHNNNCwLwc - C 29
ZtRTRvttWWzBPlGZ - ZtRTRvtt WWzBPlGZ - Z 52
tcLnctNsJrWWNDTN - tcLnctNs JrWWNDTN - N 40
pwPPSjHSHHfzvmSvvvFVVGqGVqGmFqrDWgDr - pwPPSjHSHHfzvmSvvv FVVGqGVqGmFqrDWgDr - m 13
pPSvfPQMzCQCSbhllLnQDhbtQZ - pPSvfPQMzCQCS bhllLnQDhbtQZ - Q 43
DmLffDhpVhjjVwvbwNVFbbNSNH - DmLffDhpVhjjV wvbwNVFbbNSNH - V 48
JRPBgMPRHBrMHMHqrBMqWJBSQQNbCvndNrdvCNCFwFrQnv - JRPBgMPRHBrMHMHqrBMqWJB SQQNbCvndNrdvCNCFwFrQnv - r 18
WcqJcPGMGtWRRBtgZjjspGHTLHGHTppm - WcqJcPGMGtWRRBtg ZjjspGHTLHGHTppm - G 33
ptJtWJpqRwDZZDVWpbDWqlvvflfMjlfCMjdCCdtslv - ptJtWJpqRwDZZDVWpbDWq lvvflfMjlfCMjdCCdtslv - t 20
rLwTBGBzBBQTzmwCCjvdvlLllddsMl - rLwTBGBzBBQTzmw CCjvdvlLllddsMl - L 38
NBwTmrGNgrTrcgPpWgWPDSVVPW - NBwTmrGNgrTrc gPpWgWPDSVVPW - g 7
CdglMnrlSSqDPpcsZb - CdglMnrlS SqDPpcsZb - S 45
ccwmVJtvVvVtNhBpBFPDVpqbbD - ccwmVJtvVvVtN hBpBFPDVpqbbD - V 48
TRGQjJjGTmtrTCgHWLfrcn - TRGQjJjGTmt rTCgHWLfrcn - T 46
JNNhLwWwWQHNPDmmjHpc - JNNhLwWwWQ HNPDmmjHpc - N 40
zMqZCvVCSMVqMSTVvZVGsBnlslpmsmzlPmsHPsPB - zMqZCvVCSMVqMSTVvZVG sBnlslpmsmzlPmsHPsPB - z 26
qTVqrgdCCbhfHJQFtg - qTVqrgdCC bhfHJQFtg - g 7
wNwCBBCZsfQWfmLCGSmmFRGSSF - wNwCBBCZsfQWf mLCGSmmFRGSSF - C 29
zjnPHPVqMhhZLTcbpbSncp - zjnPHPVqMhh ZLTcbpbSncp - n 14
lVlhlgzlPZlwtgBddJdfvf - lVlhlgzlPZl wtgBddJdfvf - g 7
JWRWRRLWJLnjtjnLzGzznflBvfPvPMqMDqdbzblCzC - JWRWRRLWJLnjtjnLzGzzn flBvfPvPMqMDqdbzblCzC - z 26
TTScTVbHmTsVFrmcsgcHFlPMMvlvrDPdlrDDqdldvl - TTScTVbHmTsVFrmcsgcHF lPMMvlvrDPdlrDDqdldvl - r 18
bVpcpchgsFZHbhSmSTsHFFjwtZjnjLttntNjLjNLWtjw - bVpcpchgsFZHbhSmSTsHFF jwtZjnjLttntNjLjNLWtjw - Z 52
rffjPJzWzrgPpGWHVNqTtmqFTVRH - rffjPJzWzrgPpG WHVNqTtmqFTVRH - W 49
cswhvlLBvSLsCtbFccmqVFNTbb - cswhvlLBvSLsC tbFccmqVFNTbb - c 3
wwZSCZSnCLsSDGgDmpGnfmmr - wwZSCZSnCLsS DGgDmpGnfmmr - n 14
rTfJTNtjfNljlrWSlzRtNlTqsddwGnsnHHwwhssTsnqw - rTfJTNtjfNljlrWSlzRtNl TqsddwGnsnHHwwhssTsnqw - T 46
VpbpZZbvPLbZbbBhwqMHhsGMnJdVwV - VpbpZZbvPLbZbbB hwqMHhsGMnJdVwV - V 48
mgQZJDLBJbbbcbgZClCSfWlrCjRjlDCR - mgQZJDLBJbbbcbgZ ClCSfWlrCjRjlDCR - D 30
fSpwcVfzsztcSSWNNMbnMRqTvtTv - fSpwcVfzsztcSS WNNMbnMRqTvtTv - t 20
mJFmGDDDhGhBJHCQddllqTvCllqTRRWNnMbT - mJFmGDDDhGhBJHCQdd llqTvCllqTRRWNnMbT - C 29
FdFDGdDDDhhHdZDjhDmpwSPVZszpwZsVgsPRZs - FdFDGdDDDhhHdZDjhDm pwSPVZszpwZsVgsPRZs - Z 52

J - 36
p - 16
C - 29
c - 3
t - 20
l - 12
C - 29
w - 23
g - 7
m - 13
l - 12
V - 48
H - 34
S - 45
Z - 52
C - 29
Z - 52
V - 48
R - 44
c - 3
d - 4
L - 38
R - 44
J - 36
w - 23
R - 44
B - 28
W - 49
M - 39
v - 22
L - 38
j - 10
l - 12
C - 29
L - 38
g - 7
J - 36
R - 44
b - 2
J - 36
R - 44
V - 48
m - 13
G - 33
v - 22
M - 39
Z - 52
t - 20
B - 28
C - 29
n - 14
H - 34
z - 26
h - 8
J - 36
t - 20
n - 14
w - 23
b - 2
d - 4
D - 30
p - 16
d - 4
L - 38
P - 42
C - 29
M - 39
G - 33
S - 45
W - 49
B - 28
T - 46
J - 36
r - 18
C - 29
M - 39
l - 12
d - 4
B - 28
W - 49
d - 4
B - 28
W - 49
C - 29
t - 20
H - 34
N - 40
D - 30
h - 8
t - 20
D - 30
H - 34
w - 23
c - 3
H - 34
Z - 52
b - 2
m - 13
J - 36
R - 44

Total Priority: 7845
Badge Priority: 2790